Source-Text: Tajik_Gospels.thml
Source-Format: ThML

Info: The Holy Bible. Modern Tajik translation of the four gospels. Copyright © 2008. All rights reserved. Provisional mobile phone version with Tajik translation of the UI. Test build. Not for distribution. This Java ME application made by David Haslam using Go Bible Creator 

UI-About: Оиди барнома
UI-Add-Bookmark: Нишонагузори кардан
UI-All: Хама
UI-Back: Кафо
UI-Bold: Хуруф гавз
UI-Book: Китоб
UI-Bookmarks: Нишонахо
UI-Books-Of-Moses: Таврот
UI-Books: Китобхо
UI-Cancel: Лагв кардан
UI-Change: Иваз кардан
UI-Chapter: Боб
UI-Delete-Bookmark-Alert: Нишонаро нест кунем?
UI-Delete-Bookmark: Нишонаро нест кардан
UI-Delete: Нест кардан
UI-Error: Галат
UI-Exit: Хуруч
UI-Font-Size: Андозаи калам
UI-Font-Style: Равиши калам
UI-Found: Ёфта шуд
UI-From-Book: Аз китоб
UI-Full-Screen: Тамоми сафха
UI-Gospels: Инчил
UI-Goto: Ба оят...
UI-Historical: Таърихи
UI-History: Пешина
UI-Large: Калон
UI-Loading: Боргири
UI-Major-Prophets: Пайгамбарони бузург
UI-Medium: Миёна
UI-Message-Too-Large-To-Be-Sent: Паём бузргхачм. Фиритодан номумкин
UI-Minor-Prophets: Пайгамбарони хурд
UI-New-Testament: Ахди нав
UI-Of: аз
UI-Off: Не
UI-OK: ОКей
UI-Old-Testament: Ахди кадим
UI-On: Ха
UI-Other-Letters: Номахои дигар
UI-Pauls-Letters: Номахои Павлус
UI-Phone-Number: Раками телефон
UI-Plain: Сода
UI-Please-Wait: Интизор шавед
UI-Poetic: Шеъри
UI-Preferences: Тарчихот
UI-Results: Натичахо
UI-Reverse-Characters: Харфхо баръакс кардан
UI-Reverse-Colours: Рангхо баръакс кардан
UI-Save: Хифс кардан
UI-Search-Results: Натичахои чутучу
UI-Search-Text: Чустучуи матн
UI-Search: Чустучу
UI-Searching: Дар холи чустучу
UI-Select-Verses-To-Send: Оятхоеро, ки мефирисед, итихоб кунед
UI-Select: Интихоб
UI-Send-MMS: MMS фиристодан
UI-Send-SMS: SMS фиристодан
UI-Send-Verses: Фиристодан
UI-Send: Фиристодан
UI-Small: Хурд
UI-Stop: Катъи чустучу
UI-Theme-Blue: Рангубори кабуд
UI-Theme-Computer: Рангубори компютери
UI-Theme-Floral: Гулранг
UI-Theme-Natural: Рангубори таббии
UI-Theme-Paper: Когазранг
UI-Theme-Sunshine: Офтобранг
UI-Theme: Рангубор
UI-Themes: Рангуборхо
UI-To-Book: Ба китоб
UI-To: то
UI-Verse-Does-Not-Exist: Оят вучуд надорад
UI-View: Руйхати нишонахо


Collection: Tajik Gospels
Book: Matthew
Book: Mark
Book: Luke
Book: John

Book-Name-Map: Matthew, Матто
Book-Name-Map: Mark, Маркус
Book-Name-Map: Luke, Луко
Book-Name-Map: John, Юханно
