UI-About: เกี่ยวกับ
UI-Add-Bookmark: เพิ่มในที่คั่นหนังสือ
UI-All: ทั่งหมด
UI-Back: กลับ
UI-Bold: ตัวหนา 
UI-Book: พระธรรม
UI-Bookmarks: ที่คั่นหนังสือ
UI-Books-Of-Moses: พระธรรมของโมเสส
UI-Books: พระธรรม
UI-Cancel: ยกเลิก
UI-Change: เปลี่ยน
UI-Chapter: บท
UI-Delete-Bookmark-Alert: ลบที่คั่นหนังสือที่เลือกไว้ใช่หรือไม่?
UI-Delete-Bookmark: ลบที่คั่นหนังสือ
UI-Delete: ลบ
UI-Error: ข้อผิดพลาด
UI-Exit: ออก
UI-Font-Size: ขนาดอักษร 
UI-Font-Style: รูปแบบอักษร
UI-Found: พบแล้ว
UI-From-Book: จากพระธรรม
UI-Full-Screen: เต็มจอ
UI-Gospels: พระกิตติคุณ
UI-Goto: ไปที่
UI-Historical: ประวัติศาสตร์
UI-History: ประวัติ
UI-Large: ใหญ่
UI-Loading: กำลังโหลด
UI-Major-Prophets: ผู้เผยพระวจนะใหญ่
UI-Medium: กลาง
UI-Message-Too-Large-To-Be-Sent: ข้อความมีขนาดใหญ่เกินไม่สามารถส่งได้
UI-Minor-Prophets: ผู้เผยพระวจนะน้อย
UI-New-Testament: พันธสัญญาใหม่
UI-OK: ตกลง
UI-Of: ของ
UI-Off: ปิด
UI-Old-Testament: พันธสัญญาเดิม
UI-On: เปิด
UI-Other-Letters: จดหมายอื่นๆ
UI-Pauls-Letters: จดหมายของเปาโล
UI-Phone-Number: เบอร์โทรศัพท์
UI-Plain: ธรรมดา
UI-Please-Wait: กรุญารอสักครู่
UI-Poetic:บทกวี
UI-Preferences: การตั้งค่า
UI-Results: ผลการค้นหา
UI-Reverse-Characters: สลับตัวอักษร
UI-Reverse-Colours: สลับสี
UI-Save: บันทึก
UI-Search-Results: ผลการค้นหา
UI-Search-Text: ค้นหาคำ
UI-Search: ค้นหา
UI-Searching: กำลังค้นหา
UI-Select-Verses-To-Send: เลือกข้อพระคัมภีร์ที่ต้องการส่ง
UI-Select: เลือก
UI-Send-MMS: ส่ง MMS
UI-Send-SMS: ส่ง SMS
UI-Send-Verses: ส่งข้อพระคัมภีร์
UI-Send: ส่ง
UI-Small: เล็ก
UI-Stop: หยุด
UI-Theme-Blue: สีฟ้า
UI-Theme-Computer: คอมพิวเตอร์
UI-Theme-Floral: ดอกไม้
UI-Theme-Natural: ธรรมชาติ
UI-Theme-Paper: กระดาษ 
UI-Theme-Sunshine: แสงแดด
UI-Theme: รูปแบบ 
UI-Themes: รูปแบบ
UI-To-Book: ถึงพระธรรม
UI-To: ถึง
UI-Verse-Does-Not-Exist: ไม่พบข้อความนั้น
UI-View: ดู