UI-About: About
UI-Add-Bookmark: Add Bookmark
UI-All: All
UI-Back: Back
UI-Bold: Bold
UI-Book: Book
UI-Bookmarks: Bookmarks
UI-Books-Of-Moses: Books of Moses
UI-Books: Books
UI-Cancel: Cancel
UI-Change: Change
UI-Chapter: Chapter
UI-Delete-Bookmark-Alert: Delete the selected bookmark?
UI-Delete-Bookmark: Delete Bookmark
UI-Delete: Delete
UI-Error: Error
UI-Exit: Exit
UI-Font-Size: Font size
UI-Font-Style: Font style
UI-Found: Found
UI-From-Book: From Book
UI-Full-Screen: Full screen
UI-Gospels: Gospels
UI-Goto: Go to
UI-Historical: Historical
UI-History: History
UI-Large: Large
UI-Loading: Loading
UI-Major-Prophets: Major Prophets
UI-Medium: Medium
UI-Message-Too-Large-To-Be-Sent: Message too large to be sent
UI-Minor-Prophets: Minor Prophets
UI-New-Testament: New Testament
UI-Of: of
UI-Off: Off
UI-OK: OK
UI-Old-Testament: Old Testament
UI-On: On
UI-Other-Letters: Other Letters
UI-Pauls-Letters: Paul's Letters
UI-Phone-Number: Phone Number
UI-Plain: Plain
UI-Please-Wait: Please wait
UI-Poetic: Poetic
UI-Preferences: Preferences
UI-Results: Results
UI-Reverse-Characters: Reverse Characters
UI-Reverse-Colours: Reverse Colours
UI-Save: Save
UI-Search-Results: Search Results
UI-Search-Text: Search Text
UI-Search: Search
UI-Searching: Searching
UI-Select-Verses-To-Send: Select verses to send
UI-Select: Select
UI-Send-MMS: Send MMS
UI-Send-SMS: Send SMS
UI-Send-Verses: Send Verses
UI-Send: Send
UI-Small: Small
UI-Stop: Stop
UI-Theme-Blue: Blue
UI-Theme-Computer: Computer
UI-Theme-Floral: Floral
UI-Theme-Natural: Natural
UI-Theme-Paper: Paper
UI-Theme-Sunshine: Sunshine
UI-Theme: Theme
UI-Themes: Themes
UI-To-Book: To Book
UI-To: to
UI-Verse-Does-Not-Exist: Verse does not exist
UI-View: View