UI-About: Щодо
UI-Add-Bookmark: Додати закладку
UI-All: Всі
UI-Back: Назад
UI-Bold: Жирний
UI-Book: Книга
UI-Bookmarks: Закладки
UI-Books: Книги
UI-Books-Of-Moses: П'ятикнижжя
UI-Cancel: Скасувати
UI-Change: Змінити
UI-Chapter: Розділ
UI-Delete: Вилучити
UI-Delete-Bookmark: Вилучити закладку
UI-Delete-Bookmark-Alert: Чи вилучити обрану закладку?
UI-Error: Помилка
UI-Exit: Вийти
UI-Font-Size: Розмір шрифта
UI-Font-Style: Вигляд шрифта
UI-Found: Знайдено
UI-From-Book: Від книги
UI-Full-Screen: Повний екран
UI-Gospels: Євангелії
UI-Goto: Перейти
UI-Historical: Історичні
UI-History: Журнал
UI-Large: Великий
UI-Loading: Зачекайте
UI-Major-Prophets: Великі пророки
UI-Medium: Середній
UI-Message-Too-Large-To-Be-Sent: Завелике повідомлення
UI-Minor-Prophets: Малі пророки
UI-New-Testament: Новий Заповіт
UI-Of: із
UI-Off: Вимкнути
UI-OK: Готово
UI-Old-Testament: Старий Заповіт
UI-On: Увімкнути
UI-Other-Letters: Соборні Послання
UI-Pauls-Letters: Послання Павла
UI-Phone-Number: Номер телефону
UI-Plain: Тонкий
UI-Please-Wait: Зачекайте
UI-Poetic: Поетичні
UI-Preferences: Налаштування
UI-Results: Результатів
UI-Reverse-Characters: Зворотні літери
UI-Reverse-Colours: Зворотні кольори
UI-Save: Зберегти
UI-Search: Знайти
UI-Search-Results: Результати пошуку
UI-Search-Text: Текст пошуку
UI-Searching: Йде пошук
UI-Select: Обрати
UI-Select-Verses-To-Send: Оберіть вірші для надсилання
UI-Send: Надіслати
UI-Send-MMS: Надіслати ММСку
UI-Send-SMS: Надіслати СМСку
UI-Send-Verses: Надіслати вірші
UI-Small: Малий
UI-Stop: Зупинити
UI-Theme: Тема
UI-Theme-Blue: Блакитна
UI-Theme-Computer: ЕОМ
UI-Theme-Floral: Квітчаста
UI-Theme-Natural: Природна
UI-Theme-Paper: Папір
UI-Theme-Sunshine: Соняшна
UI-Themes: Теми
UI-To: до
UI-To-Book: До книги
UI-Verse-Does-Not-Exist: Вірша не існує
UI-View: Подивитися